WWWWWWWWWWWWWWWWWWWW
WFFFFFFFFFFFFFFFFFFW
WFFFFFFFFFFFFFFFFFFW
WWWWWWWWWFFWWWWWWWWW
WFFFFFFFFFFFFFFFFFFW
WFFFFFFFFFFFFFFFFFFW
WFFFFFFFFFFFFFFFFFFW
WFFFFFFFFFFFFFFFFFFW
WFFFFWFFFFFFFFWFFFFW
WFFFFWFFFFFFFFWFFFFW
WFFFFWFFFFFFFFWFFFFW
WFFFFWFFFFFFFFWFFFFW
WFFFFWFFFFFFFFWFFFFW
WFFFFWFFFFFFFFWFFFFW
WFFFFWFFFFFFFFWFFFFW
WFFFFFFFFFFFFFFFFFFW
WFFFFFFFFFFFFFFFFFFW
WFFFFFFFFFFFFFFFFFFW
WFFFFFFFFFFFFFFFFFFW
WWWWWWWWWWWWWWWWWWWW
