WWWWWWWWWWWWWWWWWWWW
WFFFFFFFFFFFFFFFFFFW
WFFFFFFFWFFWFFFFFFFW
WWWWWWWWWFFWWWWWWWWW
WFFFFFFFFFFFFFFFFFFW
WFFFFFFWWWWWWFFFFFFW
WFFFFFFWWWWWWFFFFFFW
WFFFFFFFFFFFFFFFFFFW
WWWWWWWWFFFFWWWWWWWW
WFFFFFFFFFFFFFFFFFFW
WFFFFFFFFFFFFFFFFFFW
WFWWWWWWWWWWWWWWWWFW
WFFFFFFFFFFFFFFFFFFW
WFFFFFFFFFFFFFFFFFFW
WWWWWWFWWFFWWFWWWWWW
WFFFFFFFWFFWFFFFFFFW
WFFFFFFFWFFWFFFFFFFW
WFFFFFFFWFFWFFFFFFFW
WFFFFFFFWFFWFFFFFFFW
WWWWWWWWWWWWWWWWWWWW
